的 (de) – possessive/structural particle
一 (yī) – one, a
是 (shì) – to be
不 (bù) – not, no
了 (le) – aspect particle (completed action)
人 (rén) – person, people
我 (wǒ) – I, me
在 (zài) – at, in, on
有 (yǒu) – to have, there is
他 (tā) – he, him
这 (zhè) – this
中 (zhōng) – middle, China
大 (dà) – big, large
来 (lái) – to come
上 (shàng) – on, above, upper
国 (guó) – country, nation
个 (gè) – general measure word
到 (dào) – to arrive, to reach
说 (shuō) – to say, to speak
们 (men) – plural marker for pronouns/people
为 (wèi) – for, because of
子 (zi) – son, child, noun suffix
和 (hé) – and, with
你 (nǐ) – you
地 (dì) – earth, ground / (de) – adverbial particle
出 (chū) – to go out, to emerge
道 (dào) – way, path, method
也 (yě) – also, too
时 (shí) – time, hour
年 (nián) – year
得 (dé) – to obtain, (de) – structural particle
就 (jiù) – just, precisely, then
那 (nà) – that
要 (yào) – to want, will
下 (xià) – under, below, next
以 (yǐ) – with, by means of
生 (shēng) – to be born, life
会 (huì) – can, meeting
自 (zì) – self, from
着 (zhe) – aspect particle (continuous action)
去 (qù) – to go
之 (zhī) – of (classical/literary)
过 (guò) – to pass, to cross
家 (jiā) – home, family
学 (xué) – to study, to learn
对 (duì) – correct, towards
可 (kě) – can, may
里 (lǐ) – inside, in
话 (huà) – speech, words
工作 (gōngzuò) – work, job